######################################x#
#..........%%....  .............  .....#
#..........%.................... ......#
#.......... .........  ................#
#........########################.....##
#  .....##............##...............#
#.......##............##....  ######%###
#.......##....  ##.....##............. #
#...  ..##.......##.... ##............ #
#%%%%%%##.........##...  #########.....#
###%% ##...........##..................#
##%%###.............##.................#
##%%##....  .........###################
#..## ...............%...............  #
#.... ...............%................ #
#....###............. ############.....#
###..###.........########..............#
#....###....  ....##....%%...........  #
#....##%%.... .....##....##....#########
#.......##....###%%###....##.... ###...#
#  .....##...### ...##....##.....##....#
######..##..##  ....##.....##...%%.....#
# .......####.......##......#####......#
#...########........#####...####.......#
#.........##............##..%...... ...#
####......#########......#..#...... ...#
#####.......#%...### ....#..#..........#
#............%%......... #..#..........#
#....... .....##........  ..#..........#
#.......  .....##........ ..  ...  ....#
#...............##......##%%##.........#
#............. ..##......##%%####......#
#............  ...##...#####%###.......#
#...  .............########%%######%%###
#....  .............#######%########%###
#...........  .........................#
#....... ............... ..............#
#...... .........  ..................@.#
#......................................#
########################################
