########################################
# ........ ####### ..... #######.......#
#...........#####.........#####........#
#......#.....###.....#.....###.........#
#.....###.....#.....###.....#..........#
#....#####.........#####.......#...... #
#...####### ..... #######......#...... #
#...############################...#...#
#...##............ ...........##...#...#
#...##............ ...........##%..#...#
#...##...........   ..........##% .#...#
#...##..... ...... ...... ....##.. #%%%#
#...##....   ...........   ...##...#...#
#...##..... ............. ....##...# ..#
#%%%###%%%%#.#.#.#.#.#.#......##...#...#
#%#%####%%##############......##...#...#
#%%%#####%%%#x....... ##......##...#...#
##%#####%%###     ....######..##...#.. #
#%%%####%######## ....##...#..##.......#
#% %####%%##..........##.#.#. ##.......#
#%%%###%%##...........##.#.#..##.......#
##%#####%%##......... ##.#.#..##%#.....#
#%%%#####%%##%%%########.#.#..##%#%%...#
#%#%##.....#......... ##.#....##%#%#####
#%%%##.....#......... ##.#######.......#
##%###...  #######... ##.......##......#
#%%%##.....#  ........ ##  .....##.....#
#.#.##.....# .......... ##  .....##....#
#...##..  .#.....##########......##....#
#...##.....#...........  ##......##....#
#.. ##.....#............ ##......##....#
#.. ##.  ..########......##...  .##....#
#.. ##..........  #......##......##....#
#.. ##........... #......##......##....#
#...##  .................##......##....#
#....######################......##....#
#....##......##..  ..######.....##.....#
#....%%......%%......%%%%%%....##......#
#....##..  ..##......######...##..@....#
########################################
